111111111111111111
11P0000000000E1111
111010111111111111
111110011110000011
111101011111111011
111011011111111011
110111011111111011
110000011110000011
111111011110111111
111111011110111111
111111011110000011
111111111111111111
