111111111111111111
10001C101010001001
11101011111C001011
1010C000101C111011
11P0000000000E1111
11101C111111111111
111110011110000011
111101011111111011
111011011111111010
110111011111111011
110000011110000011
111111011110111111
111111011110111111
111111011110000011
111111111111111111
