111111
111111
10C001
1XC001
10E101
101P11
111111
