1111111
10101E1
1C00001
1C00001
1C00001
1000P01
1000CC1
1111111
