1111111
1C11111
1111111
1011111
1C00111
10C0111
10CP1E0
1111111
