111111111111
100000000011
100000000111
11111111E001
11111CCC0P11
111111111111
