111111111111111111
1CC000000E00001001
111001010010001011
101001001010101011
1000000C0CC00P1111
111111111111111111
111110011110000011
111101011111111011
111011011111111011
110111011111111011
110000011110000011
111111011110111111
111111011110111111
111111011110000011
111111111111111111
