111111111111111111
10001C101010001001
111010111110001011
101000001010101011
10E0000000000P1111
111110001111111111
1111CCC11110000011
111101011111111011
111011011111111011
110111011111111011
110000011110000011
111111011110111111
111111011110111111
111111011110000011
111111111111111111
