111111111111111111
1000NCN01010001001
1110N0N1111C001011
1010C000101C1N1011
11P000N000000EN111
11101C1111111N1111
111110011110000011
111101011111111011
111011011111111011
110111011111111011
110000011110000011
111111011110111111
111111011110111111
111111011110000011
111111111111111111
