1111111111111111111111111111111111111111
1000101010100010010000000000000000000001
1110100N111C0010110000000000000000000001
101NCN00101C1110110001111100111110000001
11P0000000000E11N10001000000100010000001
111C111111111111110001000000100010000001
1111100111100000110001111100100010000001
1111010111111110110000000100100010000001
1110110111111110110000000100100010000001
1101110111111110110001111100111110000001
1100000111100000110000000000000000000001
1111110111101111110001000000000000000001
1111110111101111110001000001000000000001
1111110111100000110001111100000000000001
1111111111111111110001000101000000000001
1111100111100000110001111101000000000001
1111010111111110110000000001000000000001
1110110111111110110000000000000000000001
1101110111111110110000000000111110000001
1100000111100000110000000000100010000001
1111110111101111110000000000111110000001
1111110111101111110000000000001010000001
1111110111100000110000000000010010000001
1111111111111111110000000000011110000001
1111111111111111111111111111111111111111
